{
  "tileSize" : 32,
  "x" : 19,
  "y" : 8,
  "tiles": [
     4, 33, 33, 33, 33, 33, 33, 33,33, 33, 33, 33, 33, 33, 33, 33, 33, 33,  5,
    18, 64, 65, 65, 65, 65, 65, 65,65, 65, 65, 65, 65, 65, 65, 65, 65, 66, 16,
    18, 80, 81, 81, 81, 81, 68, 97,97, 97, 97, 97, 69, 81, 81, 81, 81, 82, 16,
    18, 80, 81, 81, 81, 81, 82,  0, 1,  1,  1,  2, 80, 81, 81, 81, 81, 82, 16,
    18, 80, 81, 81, 81, 81, 82, 16,17, 17, 17, 18, 80, 81, 81, 81, 81, 82, 16,
    18, 80, 81, 81, 81, 81, 82, 16,17, 17, 17, 18, 80, 81, 81, 81, 81, 82, 16,
    18, 96, 97, 97, 97, 97, 98, 16,17, 17, 17, 18, 96, 97, 97, 97, 97, 98, 16,
    20,  1,  1,  1,  1,  1,  1, 21,17, 17, 17, 20,  1,  1,  1,  1,  1,  1, 21
  ],
  "texFileLoc" : "res/images/levelblocks.png"
}